     00000   
     0.c.0   
    ##...##  
    #.....#  
  #0###+###0#
  #.........#
  0.........0
  0.........0
  0.........0
  #.........#
  #####+#####
    #.....#  
    #.....#  
    #######  
