     00000   
     0.n.0   
    ##...##  
    #c...c#  
  #0###+###0#
  #.........#
  0.........0
  0.........0
  0.........0
  #.........#
  #####+#####
    #.....#  
    #.....#  
    #######  
