                     0000000
                   000..?..000
                  00.........00
            00000 #...........#
          000...00#...........#########
          0.......#...........#}}.}..}#
          0......./...........+.......#
          0.......#...........#.).))))#
          #########...........#000000##
           #......#...........#......#
           #......#...........#......#
           #......#...........#......#
     #######......#0000#+#0000#......#######
     #....#...........................#....#
     #....+...........................+....#
     #....#...........................#....#
     #....########+############/#######....#
     #....#.............#.............#....#
     #....#.............+.............#....#
     ######.............#.............######
          #############################
