                      00000
                    00.....00
                   0.........0
             000   0.........0
           00...00#...........########
          0.......#...........#.......#
          0...........................#
          0.......#...........#.......#
           ########...........#000000#
           #.......#.........#.......#
           #.......#.........#.......#
           #........##.....##........#
      #####...........##.##...........#####
     #....#...........................#....#
     #.....................................#
     #....#...........................#....#
     #....########.############.#######....#
     #....#.............#.............#....#
     #....#...........................#....#
      #####.............#.............#####
           ############# #############
