#######
#..n..#
#.....#
#.....#
#.....#
###+###
#...._#
#######
