#######
#.....#
#.....#
#.....#
#.....#
###.###
#.....#
#######
